; Everything after the ; is a comment and will be ignored by the game that
; reads in this file.
;
; The format is as follows:
;   0 - an empty open space.
;   # - A wall.
;
; The map starts and ends after the blank lines.

0000000000000000000000000000000000000000000000000000000000000000000000000000000000000000000000000000000000000000000000000000000000000000000000000000000000
0000000000000000000000000000000000000000000000000000000000000000000000000000000000000000000000000000000000000000000000000000000000000000000000000000000000
000000000000000000000000000000000000000000000000000000000S000000000000000000000000000000000000000000000000000S00000000000000000000000000000000000000000000
000000000000000000000000000S000000000000000000000000000####0000000000000000000000000000000000000000000000000###0000000000000000000000000000000000000000000
00000000000000000000000000###00000000000000000000000#######000000000000000000000000000000000000000000000000####0000000000000000000000000000000000000000000
0000000000000S0000000S0000###000000S000000S00S00S00#########0S00000000000000000000000000000000000000000S0######000000000000000000000000S0S0000000000000000
########00########00###00######000####000######################00000000000000000000SS00S0000S000000S0S0########0000#0000000000000000000###00000S0000000000
########00########00###00######000####000#######################0000000S00S00S0S000############0S0#############0000##000000000S00S000S0###0000#####000F000
########00########00###00######000####000########################S0S00#########################################0000###0S0SSS0#############0000############
########00########00###00######000####000######################################################################0000#######################0000############
########00########00###00######000####000######################################################################0000#######################0000############
########00########00###00######000####000######################################################################0000#######################0000############